# # # # # # #
# . . . . . #
# . # # # ^ #
# . # # # . #
# . # # # . #
# . . . . . #
# # # # # # #
